Row;Quantity
*,*,*,*,0,0,0,*,*,*,2,;67
3,*,6,*,0,0,0,*,*,4,2,;1
2,*,*,*,0,0,2,*,*,*,2,;1
1,1,*,*,*,0,2,0,0,0,0,;1
5,0,*,0,0,0,0,0,0,0,0,;1
4,*,*,4,0,0,0,*,*,*,2,;1
5,0,*,*,0,0,0,0,0,0,0,;1
3,*,*,*,*,0,2,*,*,*,2,;1
*,*,*,*,*,1,2,*,*,*,2,;1
5,*,*,*,0,0,0,*,*,*,2,;5
4,*,*,*,*,0,2,*,*,*,2,;1
1,*,*,*,0,0,2,*,*,*,2,;1
*,*,*,*,0,0,0,0,0,0,0,;18
5,*,*,*,0,0,0,*,*,4,2,;1
*,*,*,*,0,0,0,*,*,4,2,;7
*,3,*,*,0,0,0,*,*,*,2,;2
4,0,*,*,0,0,0,0,0,0,0,;4
5,0,*,6,0,0,0,0,0,0,0,;1
4,*,*,*,0,0,0,0,0,0,0,;6
*,*,*,*,*,0,2,*,*,*,2,;14
6,*,*,*,0,0,2,*,*,*,2,;2
1,0,*,*,0,0,2,0,0,0,0,;1
3,*,*,*,0,0,0,0,0,0,0,;5
*,*,*,6,0,0,0,*,*,*,2,;1
2,*,*,*,*,0,2,0,0,0,0,;1
2,6,*,*,*,0,2,0,0,0,0,;1
1,*,*,0,0,0,0,0,0,0,0,;2
4,*,*,*,0,0,0,*,*,*,2,;4
6,*,*,0,0,0,0,0,0,0,0,;1
6,0,*,*,0,0,0,0,0,0,0,;2
3,*,*,*,0,0,2,*,*,*,2,;1
5,*,*,4,0,0,0,*,*,*,2,;1
*,6,*,*,0,0,0,*,*,*,2,;1
3,*,*,*,0,0,0,*,*,*,2,;3
2,*,*,*,0,0,2,0,0,0,0,;2
4,*,*,*,0,0,0,*,*,4,2,;1
1,0,*,*,0,0,0,0,0,0,0,;7
*,0,*,0,0,0,0,0,0,0,0,;1
*,*,*,*,0,0,2,*,*,4,2,;1
*,*,*,5,0,0,0,0,0,0,0,;2
2,0,*,*,0,0,0,0,0,0,0,;4
4,*,*,*,0,0,2,0,0,0,0,;1
*,*,*,*,0,0,0,*,*,*,0,;3
*,5,*,*,0,0,0,*,*,*,2,;7
2,*,*,0,0,0,0,0,0,0,0,;2
2,*,*,*,0,0,0,0,0,0,0,;3
1,*,*,*,*,0,2,0,0,0,0,;1
*,*,*,5,0,0,0,*,*,*,2,;3
3,0,*,6,0,0,0,0,0,0,0,;1
6,*,*,*,*,0,2,*,*,*,2,;1
4,*,*,*,0,0,2,*,*,*,2,;2
1,*,*,*,0,0,0,*,*,4,2,;1
2,0,*,0,0,0,0,0,0,0,0,;3
1,*,*,*,0,0,0,0,0,0,0,;2
*,*,*,0,0,0,2,0,0,0,0,;2
3,3,*,*,0,0,0,0,0,0,0,;1
2,*,*,*,0,0,0,*,*,*,2,;2
3,*,*,*,0,0,2,0,0,0,0,;2
*,*,*,*,0,0,2,*,*,*,2,;17
1,3,*,*,0,0,0,0,0,0,0,;1
1,*,*,*,0,0,0,*,*,*,2,;1
6,*,*,0,0,0,2,0,0,0,0,;1
3,*,*,4,0,0,0,*,*,*,2,;1
6,*,*,*,0,0,0,0,0,0,0,;4
5,*,*,*,0,0,2,0,0,0,0,;1
5,*,*,*,*,0,2,*,*,*,2,;1
*,6,*,*,0,0,0,*,*,*,0,;1
*,*,*,*,0,0,2,0,0,0,0,;5
6,*,*,*,0,0,0,*,*,4,2,;1
3,*,*,0,0,0,0,0,0,0,0,;1
1,0,6,*,0,0,0,0,0,0,0,;1
6,*,*,*,0,0,0,*,*,*,2,;6
5,*,*,*,0,0,2,*,*,*,2,;2
1,4,*,*,0,0,2,0,0,0,0,;1
3,0,*,*,0,0,0,0,0,0,0,;4
2,*,*,4,0,0,0,*,*,*,2,;1
2,*,*,*,0,0,0,*,*,4,2,;1
2,3,*,*,0,0,0,0,0,0,0,;1
1,0,*,0,0,0,0,0,0,0,0,;3
5,*,*,*,0,0,0,0,0,0,0,;5
