Row;Quantity
1,0,0,0,0,0,0,0,0,0,0,0,0,0,0,1,*,2,2,1,;2
5,0,0,0,0,0,0,0,0,0,0,0,0,0,0,5,*,0,0,5,;1
6,*,*,*,0,0,*,0,*,*,*,0,0,0,6,4,*,1,3,4,;1
4,*,*,*,0,0,*,0,*,*,*,0,0,0,6,3,*,0,3,3,;1
3,0,0,0,0,0,0,0,0,0,0,0,0,0,6,5,*,5,2,5,;1
3,0,0,0,0,0,0,0,0,0,0,0,0,0,0,1,*,0,0,1,;2
5,0,0,0,0,0,0,0,0,0,0,0,0,0,6,4,*,2,2,4,;2
2,0,0,0,0,0,0,0,0,0,0,0,0,0,0,1,*,2,3,1,;1
6,*,*,*,0,0,*,0,*,*,*,0,0,0,0,2,*,5,2,2,;1
3,0,0,0,0,0,0,0,0,0,0,0,0,0,0,5,*,0,0,5,;1
5,*,*,*,0,0,*,0,*,*,*,0,0,0,6,4,*,3,1,4,;1
4,0,0,0,0,0,0,0,0,0,0,0,0,0,6,4,*,2,1,4,;1
5,0,0,0,0,0,0,0,0,0,0,0,0,0,6,4,*,3,2,4,;1
6,0,0,0,0,0,0,0,0,0,0,0,0,0,0,2,*,5,2,2,;1
*,*,*,*,0,0,*,0,*,*,*,0,0,0,0,2,*,5,3,2,;5
5,1,*,*,0,0,*,0,*,0,*,0,*,0,*,*,*,5,*,*,;5
1,0,0,0,0,0,0,0,0,0,0,0,0,0,0,1,*,3,2,1,;2
*,*,*,*,0,0,*,0,*,*,*,0,0,0,6,4,*,2,2,4,;1
3,0,0,0,0,0,0,0,0,0,0,0,0,0,0,2,*,5,1,2,;2
3,0,0,0,0,0,0,0,0,0,0,0,0,0,0,1,*,2,2,1,;1
4,0,0,0,0,0,0,0,0,0,0,0,0,0,0,1,*,1,3,1,;1
1,0,0,0,0,0,0,0,0,0,0,0,0,0,0,4,*,0,0,4,;1
3,0,0,0,0,0,0,0,0,0,0,0,0,0,0,4,*,0,0,4,;2
*,0,0,0,0,0,0,0,0,0,0,0,0,0,6,3,*,1,2,3,;1
3,1,*,*,0,0,*,0,*,0,*,0,*,0,*,*,*,5,*,*,;3
3,0,0,0,0,0,0,0,0,0,0,0,0,0,0,1,*,0,3,1,;1
*,*,*,*,0,0,*,0,*,*,*,0,0,0,0,1,*,1,2,1,;3
2,1,*,*,0,0,*,0,*,0,*,0,*,0,*,*,*,5,*,*,;2
4,0,0,0,0,0,0,0,0,0,0,0,0,0,0,4,*,0,0,4,;2
1,1,*,*,0,0,*,0,*,0,*,0,*,0,*,*,*,5,*,*,;1
*,*,*,*,0,0,*,0,*,*,*,0,0,0,0,1,*,2,3,1,;3
1,0,0,0,0,0,0,0,0,0,0,0,0,0,0,1,*,3,1,1,;1
2,0,0,0,0,0,0,0,0,0,0,0,0,0,0,2,*,5,2,2,;1
3,*,*,*,0,0,*,0,*,*,*,0,0,0,6,4,*,1,3,4,;2
1,0,0,0,0,0,0,0,0,0,0,0,0,0,6,5,*,5,3,5,;1
2,0,0,0,0,0,0,0,0,0,0,0,0,0,0,2,*,5,1,2,;1
5,0,0,0,0,0,0,0,0,0,0,0,0,0,0,2,*,5,2,2,;2
5,*,*,*,0,0,*,0,*,*,*,0,0,0,6,4,*,2,2,4,;1
6,*,*,*,0,0,*,0,*,*,*,0,0,0,6,4,*,2,2,4,;1
*,*,*,*,0,0,*,0,*,*,*,0,0,0,0,0,0,1,3,0,;1
5,0,0,0,0,0,0,0,0,0,0,0,0,0,6,5,*,5,2,5,;1
1,0,0,0,0,0,0,0,0,0,0,0,0,0,0,1,*,3,0,1,;1
*,1,*,*,0,0,*,0,*,0,*,0,*,0,*,*,*,5,*,*,;52
2,0,0,0,0,0,0,0,0,0,0,0,0,0,0,1,*,2,1,1,;1
*,*,*,*,0,0,*,0,*,*,*,0,0,0,0,1,*,2,2,1,;2
1,0,0,0,0,0,0,0,0,0,0,0,0,0,0,2,*,5,2,2,;1
6,1,*,*,0,0,*,0,*,0,*,0,*,0,*,*,*,5,*,*,;5
1,0,0,0,0,0,0,0,0,0,0,0,0,0,0,1,*,0,0,1,;6
3,0,0,0,0,0,0,0,0,0,0,0,0,0,6,4,*,1,1,4,;1
*,0,0,0,0,0,0,0,0,0,0,0,0,0,6,4,*,1,3,4,;1
1,*,*,*,0,0,*,0,*,*,*,0,0,0,6,4,*,3,3,4,;1
*,*,*,*,0,0,*,0,*,*,*,0,0,0,0,2,*,5,2,2,;2
2,0,0,0,0,0,0,0,0,0,0,0,0,0,0,1,*,0,0,1,;3
*,0,0,0,0,0,0,0,0,0,0,0,0,0,6,3,6,0,1,3,;1
6,0,0,0,0,0,0,0,0,0,0,0,0,0,6,4,*,2,2,4,;2
2,0,0,0,0,0,0,0,0,0,0,0,0,0,0,1,*,2,2,1,;1
*,*,*,*,0,0,*,0,*,*,*,0,0,0,0,1,*,3,2,1,;4
4,*,*,*,0,0,*,0,*,*,*,0,0,0,6,3,6,0,2,3,;1
*,*,*,*,0,0,*,0,*,*,*,0,0,0,6,4,*,2,3,4,;1
6,0,0,0,0,0,0,0,0,0,0,0,0,0,0,5,*,0,0,5,;1
4,0,0,0,0,0,0,0,0,0,0,0,0,0,6,4,*,2,2,4,;1
5,0,0,0,0,0,0,0,0,0,0,0,0,0,0,3,*,0,0,3,;2
3,0,0,0,0,0,0,0,0,0,0,0,0,0,6,5,*,5,3,5,;1
5,*,*,*,0,0,*,0,*,*,*,0,0,0,6,4,*,1,3,4,;1
4,0,0,0,0,0,0,0,0,0,0,0,0,0,0,5,*,0,0,5,;1
*,*,*,*,0,0,*,0,*,*,*,0,0,0,0,0,0,2,2,0,;2
1,0,0,0,0,0,0,0,0,0,0,0,0,0,0,1,*,1,1,1,;1
5,*,*,*,0,0,*,0,*,*,*,0,0,0,0,2,*,5,2,2,;1
*,0,0,0,0,0,0,0,0,0,0,0,0,0,6,3,*,2,3,3,;1
2,*,*,*,0,0,*,0,*,*,*,0,0,0,6,4,*,1,2,4,;1
*,*,*,*,0,0,*,0,*,*,*,0,0,0,0,1,*,1,3,1,;4
4,0,0,0,0,0,0,0,0,0,0,0,0,0,0,1,*,0,0,1,;1
*,0,0,0,0,0,0,0,0,0,0,0,0,0,6,4,*,1,1,4,;1
*,*,*,*,0,0,*,0,*,*,*,0,0,0,0,0,0,1,2,0,;1
4,0,0,0,0,0,0,0,0,0,0,0,0,0,6,5,*,5,2,5,;2
3,0,0,0,0,0,0,0,0,0,0,0,0,0,0,1,*,2,1,1,;1
1,0,0,0,0,0,0,0,0,0,0,0,0,0,0,1,*,3,3,1,;1
2,0,0,0,0,0,0,0,0,0,0,0,0,0,0,1,*,1,2,1,;2
6,*,*,*,0,0,*,0,*,*,*,0,0,0,0,2,*,5,3,2,;1
6,1,*,*,0,0,*,0,*,0,*,0,*,0,*,*,*,0,*,*,;1
1,0,0,0,0,0,0,0,0,0,0,0,0,0,0,1,*,1,3,1,;2
*,0,0,0,0,0,0,0,0,0,0,0,0,0,0,4,*,0,0,4,;1
4,0,0,0,0,0,0,0,0,0,0,0,0,0,0,2,*,5,2,2,;1
2,0,0,0,0,0,0,0,0,0,0,0,0,0,0,1,*,3,2,1,;2
3,*,*,*,0,0,*,0,*,*,*,0,0,0,6,4,*,3,1,4,;1
1,0,0,0,0,0,0,0,0,0,0,0,0,0,0,5,*,0,0,5,;1
5,*,*,*,0,0,*,0,*,*,*,0,0,0,6,4,*,3,3,4,;1
*,0,0,0,0,0,0,0,0,0,0,0,0,0,6,3,6,2,2,3,;1
4,*,*,*,0,0,*,0,*,*,*,0,0,0,6,3,*,2,3,3,;1
3,0,0,0,0,0,0,0,0,0,0,0,0,0,0,1,*,3,2,1,;2
2,0,0,0,0,0,0,0,0,0,0,0,0,0,6,5,*,5,3,5,;2
*,*,*,*,0,0,*,0,*,*,*,0,0,0,0,1,*,3,3,1,;4
1,0,0,0,0,0,0,0,0,0,0,0,0,0,0,1,*,1,2,1,;1
*,0,0,0,0,0,0,0,0,0,0,0,0,0,6,4,*,3,2,4,;2
4,1,*,*,0,0,*,0,*,0,*,0,*,0,*,*,*,5,*,*,;4
2,0,0,0,0,0,0,0,0,0,0,0,0,0,0,4,*,0,0,4,;3
*,1,*,*,0,0,*,0,*,0,*,0,*,0,*,*,*,0,*,*,;15
*,*,*,*,0,0,*,0,*,*,*,0,0,0,6,4,*,0,2,4,;1
4,0,0,0,0,0,0,0,0,0,0,0,0,0,0,1,*,2,2,1,;1
4,0,0,0,0,0,0,0,0,0,0,0,0,0,0,2,*,5,1,2,;1
*,0,0,0,0,0,0,0,0,0,0,0,0,0,6,4,*,0,2,4,;1
*,*,*,*,0,0,*,0,*,*,*,0,*,0,*,*,*,5,*,*,;40
*,*,*,*,0,0,*,0,*,*,*,0,0,0,0,0,0,0,2,0,;1
*,0,0,0,0,0,0,0,0,0,0,0,0,0,6,4,*,3,1,4,;1
2,0,0,0,0,0,0,0,0,0,0,0,0,0,0,1,*,3,3,1,;1
6,0,0,0,0,0,0,0,0,0,0,0,0,0,0,4,*,0,0,4,;1
2,*,*,*,0,0,*,0,*,*,*,0,0,0,6,4,*,3,2,4,;1
6,0,0,0,0,0,0,0,0,0,0,0,0,0,6,4,*,3,2,4,;2
6,*,*,*,0,0,*,0,*,*,*,0,0,0,6,4,*,3,2,4,;1
4,*,*,*,0,0,*,0,*,*,*,0,0,0,6,3,6,1,2,3,;1
